00222222222222222222222
00000000000000000000003
50000000000000000000003
50000000000000000000003
50000000000000000000003
50000000000000000000003
50000000000000000000003
50000000000000000000003
50000000000000000000003
50000000000000000000003
50000000000000000000003
50000000000000000000003
50000000000000000000003
50000000000000000000003
50000000000000000000003
50000000000000000000003
50000000000000000000003
50000000000000000000000
04444444444444444444400