00000000000000000000000
11111111111111111110000
11111111111111111110000
11111111111111111110000
11111111111111111110000
11111111111111111110000
00000000000000000000000
01111111111111111111111
01111111111111111111111
01111111111111111111111
01111111111111111111111
01111111111111111111111
01111111111111111111111
01111111111111111111111
01111111111111111111111
01111111111111111111111
01111111111111111111111
01111111111111111111111
00000000000000000000000
