0000000000000000000000000000
1111111111111111111111000000
1111111111111111111111000000
1111111111111111111111000000
1111111111111111111111000000
1111111111111111111111000000
0000000000000000000000000000
0111111111111111111111100000
0111111111111111111111100000
0111111111111111111111100000
0111111111111111111111100000
0111111111111111111111100000
0111111111111111111111100000
0111111111111111111111100000
0111111111111111111111100000
0111111111111111111111100000
0111111111111111111111100000
0111111111111111111111100000
0000000000000000000000000000
